0, 0, 0, 0, 0, 0, 1, 1, 1, 1, 1, 1, 1, 0, 0
101, 1, 1, 1, 0, 0, 1, 1, 1, 0, 0, 1, 1, 0, 0
1, 2, 201, 1, -1, 1, 1, 1, 1, 0, 0, 1, 1, 1, 1
1, 1, 1, 1, 0, 0, 0, 0, 0, 0, 0, 1, 1, 3, 1
1, 1, 1, 1, 0, 0, 0, 0, 0, 0, 0, 1, 1, 1, 1
0, 0, 0, 0, 0, 0, 0, 0, 0, 0, 0, 0, 1, 1, 100
